1111111111111111111111111111111111
1E10C0000000000C00000C000000010001
1010011100010000111001000000010101
1010010001110000001001000000010101
1010010001C10000001001000000010101
1010010001000000001001000000010101
1010010001110000001001000000010101
1000000000C000000000000000000001P1
1111111111111111111111111111111111